1111111111111111111111111111111
1     1     1     1     1     1
1     1     1     1     1     1
1                             1
1     1     1     1     1     1
1     1     1     1     1     1
111 11111 11111 11111 11111 111
1     1     1     1     1     1
1     1     1     1     1     1
1                             1
1     1     1     1     1     1
1     1     1     1     1     1
111 11111 11111 11111 11111 111
1     1     1     1     1     1
1     1     1     1     1     1
1                             1
1     1     1     1     1     1
1     1     1     1     1     1
111 11111 11111 11111 11111 111
1     1     1     1     1     1
1     1     1     1     1     1
1                             1
1     1     1     1     1     1
1     1     1     1     1     1
111 11111 11111 11111 11111 111
1     1     1     1     1     1
1     1     1     1     1     1
1                             1
1     1     1     1     1     1
1     1     1     1     1     1
1111111111111111111111111111111