1111111111111111111111111111111
1     1     1     1     1     1
1     1     1     1     1     1
1     2     2     2     2     1
1     1     1     1     1     1
1     1     1     1     1     1
1112111112111112111112111112111
1     1     1     1     1     1
1     1     1     1     1     1
1     2     2     2     2     1
1     1     1     1     1     1
1     1     1     1     1     1
1112111112111112111112111112111
1     1     1     1     1     1
1     1     1     1     1     1
1     2     2     2     2     1
1     1     1     1     1     1
1     1     1     1     1     1
1112111112111112111112111112111
1     1     1     1     1     1
1     1     1     1     1     1
1     2     2     2     2     1
1     1     1     1     1     1
1     1     1     1     1     1
1112111112111112111112111112111
1     1     1     1     1     1
1     1     1     1     1     1
1     2     2     2     2     1
1     1     1     1     1     1
1     1     1     1     1     1
1111111111111111111111111111111