1111111111111111111111111111111
1     1     1     1     1     1
1     1     1     1     1     1
1     2  4  2     2     2     1
1     1     1     1     1     1
1     1     1     1     1     1
1112111112111112111112111112111
1     1     1     1     1     1
1     1     1     1     1     1
1     2  5  2  3  2  4  2  5  1
1     1     1     1     1     1
1     1     1     1     1     1
1112111112111112111112111112111
1     1     1     1     1     1
1     1     1     1     1     1
1     2     2  5  2  3  2  3  1
1     1     1     1     1     1
1     1     1     1     1     1
1112111112111112111112111112111
1     1     1     1     1     1
1     1     1     1     1     1
1     2     2     2  4  2     1
1     1     1     1     1     1
1     1     1     1     1     1
1112111112111112111112111112111
1     1     1     1     1     1
1     1     1     1     1     1
1     2     2     2     2  6  1
1     1     1     1     1     1
1     1     1     1     1     1
1111111111111111111111111111111
